11 20
XXXXXXXXXXXXXXXXXXXX
X    X        X    X
X XX X XXXXXX X XX X
X X              X X
X X XX XX  XX XX X X
X      XS   X      X
X X XX XXXXXX XX X X
X X              X X
X XX X XXXXXX X XX X
X    X   G    X    X
XXXXXXXXXXXXXXXXXXXX
