5 5
XXXXX
XG  X
X   X
X  SX
XXXXX
