7 9
XXXXXXXXX
X       X
XXXX XX X
X       X
X XX XX X
XSX   G X
XXXXXXXXX
